FTSE100 - 2009/2010


Component	Name	full_data?	Continues_in_2016?	Sector

AAL.L	Anglo American plc	T	T
ABF.L	Associated British food plc	T	T
ADM.L	Admiral Group plc	T	T
AMFW.L	Amec Foster Wheeler	T	F
ANTO.L	Antofagasta plc 	T	T
ATST.L	Alliance Trust Ord	T	F
AV.L	Aviva plc	T	T
AZN.L	AstraZeneca plc	T	T
BA.L	BAE Systems plc	T	T
BARC.L	Barclays plc	T	T	Banking
BATS.L	British American Tobacco plc	T	T
BG.L	BG Group plc	T	T
BLND.L	The British Land Company plc	T	T
BLT.L	BHP Billiton plc	T	T
BNZL.L	Bunzl plc	T	T
BP.L	BP plc	T	T
BT-A.L	BT Group plc	T	T
CCL.L	Carnival plc	T	T
CNA.L	Centrica plc	T	T
CNE.L	Cairn Energy plc	T	F
COB.L	Cobham plc	T	F
CPG.L	Compass Group plc	T	T
CPI.L	Capita plc	T	T
DGE.L	Diageo plc	T	T
EMG.L	Man Group plc	T	F
EXPN.L	Experian plc	T	T
GFS.L	G4S plc	T	F
GSK.L	GlaxoSmithKline plc	T	T
HMSO.L	Hammerson plc	T	T
HOME.L	Home Retail Group plc	T	F
HSBA.L	HSBC Holdings plc	T	T
IAG.L	International Consolidated Airlines Group	F	T
IAP.L	ICAP plc	T	F
IHG.L	Intercontinental Hotels Group	T	T
III.L	3i Group plc	T	F
IMB.L	Imperial Brands	T	T
INTU.L	intu properties plc	T	F
ISAT.L	Inmarsat plc	T	F
JMAT.L	Johnson Matthey plc	T	T
KAZ.L	KAZ Minerals plc	T	F
KGF.L	Kingfisher plc	T	T
LAND.L	Land Securities Group plc	T	T
LGEN.L	Legan & General Group plc	T	T
LLOY.L	Lloyds Banking Group	T	T	Banking
LSE.L	London Stock Exchange Group plc	T	F
MKS.L	Marks & Spencer Group plc	T	T
MRW.L	Wm. Morrison Supermarkets plc	T	T
NG.L	National Grid plc	T	T
NXT.L	Next plc	T	T
OML.L	Old Mutual plc	T	T
PRU.L	Prudential plc	T	T
PSON.L	Pearson plc	T	T
RB.L	Reckitt Benckiser Group plc	T	T
RBS.L	The Royal Bank of Scotland Group plc	T	T	Banking
RDSA.L	Royal Dutch Shell plc	T	T
RDSB.L	Royal Dutch Shell plc	T	T
REL.L	RELX plc	T	T
REX.L	Rexam plc	T	F
RIO.L	Rio Tinto plc	T	T
RR.L	Rolls Royce Holdings plc	T	T
RRS.L	Randgold Resources Limited	T	T
RSA.L	RSA Insurance Group	T	T
SAB.L	SABMiller plc	T	T
SBRY.L	J Sainsbury plc	T	T
SDR.L	Schroders plc	T	T
SDRC.L	Schroders plc	F	F
SGE.L	Sage Group plc	T	T
SHP.L	Shire plc	T	T
SKY.L	SKY	T	T
SL.L	Standard Life plc	T	T
SMIN.L	Smiths Group plc	T	T
SN.L	Smith & Nephew plc	T	T
SRP.L	Serco Group plc	T	F
SSE.L	SSE plc	T	T
STAN.L	Standard Chartered plc	T	T
SVT.L	Severn Trent plc	T	T
TCG.L	Thomas Cook Group	F	F
TLW.L	Tullow Oil plc	T	F
TSCO.L	Tesco plc	T	T
ULVR.L	Unilever plc	T	T
UU.L	United Utilities Group plc	T	T
VED.L	Vedanta Resources plc	T	F
VOD.L	Vodafone Group plc	T	T
WOS.L	Wolseley plc	T	T
WPP.L	WPP plc	T	T
WTB.L	Whitbread plc	T	T




**********************************************************************************************
Comments *
**********
IAG.L --> faltan datos!
SDR.L / SDRC.L --> misma compañia, en que se diferencian los valores??? SDRC.L desaparece en torno a 2010 pero la otra continua


*************************************************************************************************
Not found *
***********

AU	Autonomy Corp
BSBE	Invensys
CBRY	Cadbury
CW	Cable and Wireless Worl...
DAT.L	Datang International Power Generation   <-- found in yahoo, but not in the range: wtf????
ENCR	Eurasian Naturan Res.
TUI.L	TUI AG   <-- found in yahoo (not in range)
XTA	Xstrata plc



http://siblisresearch.com/data/historical-components-ftse-100/
